X..........................X
X..........................X
X..........................X
XXX....XXX............XX...X
XXX.P......IE.I............X
XXXXX.......XX...........XXX
XXXXX.....TTXX...I.E...FI..X
XXXXXXXXXXXXXXXX..XXXXXX...X
X......X..XXXXXX..XX..XXX..X
XXXXXXXXXXXXXXXXXXXXXXXXXXXX
LLLLLLLLLLLLLLLLLLLLLLLLLLLL