X..........................X
X..........................X
X..........................X
X...............I...S...I..X
XXX....XXX...... XXXXXXX...X
XXX.P......IE.I............X
XXXXX.......XX...........XXX
X.........TTXX...I.E.S.FI..X
X......X..XXXXXX..XXXXXX...X
XTTT...X..XXXXXX..XX..XXX..X
XXXXXXXX..XXXXXX..XX..XXXXXX