X..........................X
X..........................X
X......................X...X
XXXX...I....E...E..I...XTTTX
XTTT.....XXXXXXXXXX...XXXXXX
XXXXX......IS.I..........F.X
X......XX...XX...........XXX
XP........TTXXTT.I.E....I..X
XXXXXXXXXXXXXXXX..XXXXXX...X
XTTT..XXTTXXXXTX..XX..XXXTTX
XXXXXXXXXXXXXXTX..XXXXXXXXXX